0,0,M,M,M,M,M,M,0,0,0,0
0,0,M,0,0,0,0,M,0,0,0,0
M,M,M,$,$,$,0,M,0,0,0,0
M,0,0,$,.,.,0,M,0,0,0,0
M,@,$,.,.,.,M,M,0,0,0,0
M,M,M,M,0,0,M,0,0,0,0,0
0,0,0,M,M,M,M,0,0,0,0,0
0,0,0,0,0,0,0,0,0,0,0,0
0,0,0,0,0,0,0,0,0,0,0,0
0,0,0,0,0,0,0,0,0,0,0,0
0,0,0,0,0,0,0,0,0,0,0,0
0,0,0,0,0,0,0,0,0,0,0,0
